abandon	abandonment
abase	abasement
abash	abashment
abate	abatement
abdicate	abdication
abduct	abduction
aberrate	aberrance
aberrate	aberration
abet	abetment
abhor	abhorrence
abide	abidance
abjure	abjuration
ablate	ablation
abnegate	abnegation
abolish	abolishment
abolish	abolition
abominate	abomination
abort	abortion
about-face	about-face
abrade	abrasion
abreact	abreaction
abrogate	abrogation
abscise	abscission
abscond	abscondment
absent	absence
absolve	absolution
absorb	absorption
abstract	abstraction
abuse	abuse
accede	accession
accelerate	acceleration
accentuate	accentuation
accept	acceptance
accept	acceptation
access	access
access	accession
acclaim	acclaim
acclaim	acclamation
acclimate	acclimation
acclimatise	acclimatisation
acclimatize	acclimatization
accommodate	accommodation
accompany	accompaniment
accomplish	accomplishment
accord	accord
accord	accordance
accredit	accreditation
accrete	accretion
accrue	accrual
accrue	accruement
acculturate	acculturation
accumulate	accumulation
accuse	accusal
accuse	accusation
ace	ace
acetylate	acetylation
ache	ache
achieve	achievement
acidify	acidification
acknowledge	acknowledgment
acquiesce	acquiescence
acquire	acquisition
act	act
act	action
action	action
activate	activation
actualise	actualisation
actualize	actualization
actuate	actuation
adapt	adaptation
addict	addiction
address	address
adduct	adduction
adjoin	adjunction
adjourn	adjournment
adjure	adjuration
adjust	adjustment
administer	administration
admire	admiration
admit	admission
admonish	admonishment
admonish	admonition
adolesce	adolescence
adopt	adoption
adorn	adornment
adsorb	adsorption
advance	advance
advance	advancement
advect	advection
adventure	adventure
advert	advertence
advertise	advertisement
advertize	advertizement
advise	advisement
aerate	aeration
aestivate	aestivation
affect	affect
affiliate	affiliation
affirm	affirmation
affix	affixation
afflict	affliction
afforest	afforestation
affront	affront
age	age
agglutinate	agglutination
aggrandise	aggrandisement
aggrandize	aggrandizement
aggravate	aggravation
aggress	aggression
agree	agreement
aid	aid
aim	aim
airlift	airlift
alert	alert
align	alignment
aliment	alimentation
allege	allegement
alleviate	alleviation
alliterate	alliteration
allocate	allocation
allot	allotment
allow	allowance
allude	allusion
allure	allurement
ally	alliance
alphabetize	alphabetization
alter	alteration
alternate	alternation
amaze	amazement
amble	amble
ambulate	ambulation
ambuscade	ambuscade
ambush	ambush
ameliorate	amelioration
amend	amendment
americanise	americanisation
americanize	americanization
ammonify	ammonification
amnesty	amnesty
amortise	amortisation
amortize	amortization
amputate	amputation
amuse	amusement
anathematise	anathematisation
anathematise	anathematization
anathematize	anathematization
anger	anger
anguish	anguish
animadvert	animadversion
annihilate	annihilation
annotate	annotation
announce	announcement
annoy	annoyance
annul	annulment
anoint	anointment
answer	answer
antecede	antecedence
antic	antic
appeal	appeal
appear	apparition
appear	appearance
apperceive	apperception
apply	application
apportion	apportionment
appose	apposition
appraise	appraisal
apprehend	apprehension
apprise	apprisal
approach	approach
approbate	approbation
approbate	approval
approve	approbation
approve	approval
arbitrage	arbitrage
arbitrate	arbitrament
arbitrate	arbitration
arbitrate	arbitrement
argue	argument
argue	argumentation
arm	armament
arouse	arousal
arrest	arrest
arrive	arrival
arrogate	arrogation
articulate	articulation
ascend	ascension
ascribe	ascription
asperse	aspersion
asphyxiate	asphyxiation
aspirate	aspiration
assassinate	assassination
assault	assault
assay	assay
assent	assent
assert	assertion
assess	assessment
asseverate	asseveration
assibilate	assibilation
assign	assignation
assign	assignment
assimilate	assimilation
assist	assist
assist	assistance
associate	association
assonate	assonance
assort	assortment
assuage	assuagement
assume	assumption
assure	assurance
astonish	astonishment
atomise	atomisation
atomize	atomization
atone	atonement
atrophy	atrophy
attach	attachment
attack	attack
attain	attainment
attempt	attempt
attend	attendance
attend	attention
attenuate	attenuation
attest	attestation
attract	attraction
attract	attractor
attribute	attribution
auction	auction
audit	audit
audition	audition
augment	augmentation
auscultate	auscultation
authenticate	authentication
authorise	authorisation
authorize	authorization
automate	automation
autopsy	autopsy
avalanche	avalanche
aver	averment
avert	aversion
aviate	aviation
avoid	avoidance
avow	avowal
avulse	avulsion
awe	awe
baa	baa
backfire	backfire
background	background
backhand	backhand
backlash	backlash
bag	bag
bail	bailment
balance	balance
ballot	ballot
ballyhoo	ballyhoo
ban	ban
bang	bang
banish	banishment
bank	bank
banter	banter
bar	bar
barbarise	barbarisation
barbarize	barbarization
barbecue	barbecue
bark	bark
bar_mitzvah	bar_mitzvah
barrage	barrage
barter	barter
bash	bash
bastardise	bastardisation
bastardize	bastardization
bath	bath
bathe	bathe
bat_mitzvah	bat_mitzvah
battle	battle
bay	bay
beat	beat
beatify	beatification
beautify	beautification
bedevil	bedevilment
beef	beef
beep	beep
befoul	befoulment
belch	belch
bell	bell
bellow	bellow
belly_dance	belly_dance
belt	belt
bemuse	bemusement
benefact	benefaction
beneficiate	beneficiation
bereave	bereavement
bestow	bestowal
bestow	bestowment
bet	bet
betray	betrayal
betroth	betrothal
better	better
better	betterment
bicker	bicker
bid	bid
biff	biff
bifurcate	bifurcation
billow	billow
binge	binge
bioassay	bioassay
birdie	birdie
birr	birr
birth	birth
bisect	bisection
bitch	bitch
bite	bite
blackball	blackball
blackmail	blackmail
black_market	black_market
blame	blame
blandish	blandishment
blare	blare
blast	blast
blather	blather
blaze	blaze
bleach	bleach
bleat	bleat
bleep	bleep
blend	blend
blether	blether
blight	blight
blink	blink
blitz	blitz
bloat	bloat
blockade	blockade
block	block
bloom	bloom
blossom	blossom
blow	blow
bluff	bluff
blunder	blunder
blush	blush
bluster	bluster
boast	boast
bob	bob
bogey	bogey
boil	boil
bolt	bolt
bombard	bombardment
bomb	bomb
bombilate	bombilation
bombinate	bombination
boo	boo
boom	boom
boomerang	boomerang
boondoggle	boondoggle
boost	boost
boot	boot
botch	botch
bother	bother
bother	botheration
bounce	bounce
bound	bound
bow	bow
bowdlerise	bowdlerisation
bowdlerize	bowdlerization
box	box
boycott	boycott
brachiate	brachiation
brag	brag
brandish	brandish
bravo	bravo
brawl	brawl
bray	bray
breach	breach
break	break
break_dance	break_dance
breakfast	breakfast
breathe	breather
breeze	breeze
broil	broil
browse	browse
bruise	bruise
brunch	brunch
brush	brush
brutalise	brutalisation
brutalize	brutalization
bump	bump
bunco	bunco
bungle	bungle
bunt	bunt
burden	burden
burlesque	burlesque
burn	burn
burp	burp
burst	burst
bury	burial
buss	buss
bust	bust
bustle	bustle
buy	buy
buzz	buzz
cabal	cabal
cachinnate	cachinnation
cackle	cackle
cakewalk	cakewalk
calcify	calcification
calcine	calcination
calculate	calculation
calibrate	calibration
call	call
call_up	call_up
calm	calm
camouflage	camouflage
campaign	campaign
canal	canalisation
canal	canalization
canalise	canalisation
canalize	canalization
cancel	cancellation
canker	canker
cannonade	cannonade
cannon	cannon
cannulate	cannulation
cannulate	cannulisation
cannulate	cannulization
cannulate	canulisation
cannulate	canulization
cannulise	cannulization
cannulize	cannulisation
canonise	canonisation
canonize	canonization
canter	canter
cantillate	cantillation
canulate	canulation
canvass	canvass
caper	caper
capitalise	capitalisation
capitalize	capitalization
capitulate	capitulation
captivate	captivation
capture	capture
carbonate	carbonation
carbonise	carbonisation
carbonize	carbonization
care	care
careen	careen
caress	caress
carom	carom
carouse	carousal
carouse	carouse
carry	carry
carry_over	carry-over
cartwheel	cartwheel
cast	cast
castigate	castigation
castle	castle
castrate	castration
catalog	catalog
catalogue	catalogue
catcall	catcall
catch	catch
categorize	categorization
caterwaul	caterwaul
catnap	catnap
caucus	caucus
cause	causation
cause	cause
cauterise	cauterisation
cauterize	cauterization
caution	caution
cave_in	cave_in
cavil	cavil
caw	caw
cease	cease
cease	cessation
cede	cession
celebrate	celebration
censure	censure
census	census
centralise	centralisation
centralize	centralization
centrifuge	centrifugation
cerebrate	cerebration
certify	certification
chagrin	chagrin
challenge	challenge
chance	chance
change	change
change_over	changeover
channel	channelisation
channel	channelization
channelise	channelisation
channelize	channelization
characterise	character
characterise	characterisation
characterize	character
characterize	characterization
charge	charge
chase	chase
chasse	chasse
chastise	chastisement
chat	chat
chatter	chatter
cheat	cheat
check	check
checkmate	checkmate
cheek	cheek
cheep	cheep
cheer	cheer
chelate	chelation
chemisorb	chemisorption
chemisorb	chemosorption
chew	chew
chicane	chicane
chill	chill
chink	chink
chip	chip
chirp	chirp
chirrup	chirrup
chitchat	chitchat
chlorinate	chlorination
chomp	chomp
chop	chop
chortle	chortle
chorus	chorus
christianise	christianisation
christianize	christianization
chronicle	chronicle
chuckle	chuckle
chug	chug
church	church
cinch	cinch
circle	circle
circuit	circuit
circularise	circularisation
circularize	circularization
circulate	circulation
circumcise	circumcision
circumnavigate	circumnavigation
circumscribe	circumscription
circumvent	circumvention
circumvolve	circumvolution
cite	citation
civilise	civilisation
clack	clack
claim	claim
clamber	clamber
clamor	clamor
clamour	clamour
clang	clang
clang	clangor
clangor	clangor
clangour	clangour
clank	clank
clap	clap
clarify	clarification
clash	clash
clasp	clasp
classify	classification
clatter	clatter
clear	clear
clear	clearance
clench	clench
click	click
climax	climax
climb	climb
clinch	clinch
clink	clink
clip	clip
clog	clog
close	close
cloud	cloud
clout	clout
cluck	cluck
clump	clump
clunk	clunk
clutch	clutch
clutter	clutter
coact	coaction
coagulate	coagulation
coalesce	coalescence
coalesce	coalition
coast	coast
codify	codification
coerce	coercion
coexist	coexistence
cogitate	cogitation
cognise	cognisance
cognize	cognizance
cohabit	cohabitation
cohere	coherence
cohere	cohesion
cold-shoulder	cold_shoulder
collaborate	collaboration
collapse	collapse
collar	collar
collate	collation
collect	collection
collectivise	collectivisation
collectivize	collectivization
collide	collision
colligate	colligation
collimate	collimation
collocate	collocation
collude	collusion
colonise	colonisation
colonize	colonization
color	coloration
combat	combat
comb	comb
combine	combination
combine	combine
combust	combustion
comfort	comfort
command	command
command	commandment
commemorate	commemoration
commence	commencement
commentate	comment
comment	comment
commercialise	commercialisation
commercialize	commercialization
commiserate	commiseration
commission	commission
commit	commission
commit	commitment
commit	committal
commune	communion
communicate	communication
communise	communisation
communize	communization
commute	commutation
compact	compaction
compartmentalise	compartmentalisation
compartmentalize	compartmentalization
compel	compulsion
compensate	compensation
compete	competition
compile	compilation
complete	completion
complicate	complication
compliment	compliment
comply	compliance
comport	comportment
compose	composition
comprehend	comprehension
compress	compression
compromise	compromise
compute	computation
computerize	computerization
concatenate	concatenation
conceal	concealment
concede	concession
conceive	conception
concentrate	concentration
conceptualise	conceptualisation
conceptualize	conceptualization
concern	concern
conciliate	conciliation
conclude	conclusion
concoct	concoction
con	con
concord	concord
concord	concordance
concrete	concretion
concur	concurrence
concuss	concussion
condemn	condemnation
condense	condensation
condescend	condescension
condition	condition
condole	condolence
condone	condonation
conduct	conduction
confab	confab
confabulate	confabulation
confect	confection
confection	confection
confederate	confederation
confer	conferee
confer	conference
confer	conferment
confer	conferral
confess	confession
confine	confinement
confirm	confirmation
confiscate	confiscation
conflict	conflict
conform	conformance
conform	conformation
confront	confrontation
confuse	confusion
confute	confutation
conga	conga
congeal	congelation
conge	conge
congest	congestion
conglobe	conglobation
conglomerate	conglomeration
conglutinate	conglutination
congratulate	congratulation
congregate	congregation
conjecture	conjecture
conjugate	conjugation
conjure	conjuration
connect	connection
connect	connexion
connive	connivance
conscript	conscription
consecrate	consecration
consent	consent
conserve	conservation
consider	consideration
consign	consignment
consist	consistence
console	consolation
consolidate	consolidation
constellate	constellation
constipate	constipation
constitute	constitution
constitutionalize	constitutional
constrict	constriction
construct	construction
consult	consultation
consume	consumption
consummate	consummation
contact	contact
contain	containment
contaminate	contamination
contemplate	contemplation
contend	contention
content	content
content	contentment
contest	contest
contest	contestation
continue	continuance
continue	continuation
contort	contortion
contract	contract
contract	contraction
contra_danse	contra_danse
contradict	contradiction
contrast	contrast
contravene	contravention
contredanse	contredanse
contribute	contribution
contrive	contrivance
control	control
contuse	contusion
convalesce	convalescence
convect	convection
convene	convention
conventionalise	conventionalisation
conventionalize	conventionalization
converge	convergence
converse	conversation
convert	conversion
convey	conveyance
convict	conviction
convoke	convocation
convolute	convolution
convolve	convolution
convoy	convoy
convulse	convulsion
cooccur	co-occurrence
coo	coo
cooperate	cooperation
co-opt	co-optation
co-opt	co-option
coordinate	coordination
copulate	copulation
corner	corner
coronate	coronation
corrade	corrasion
correct	correction
correlate	correlation
correspond	correspondence
corroborate	corroboration
corrode	corrosion
corrugate	corrugation
corrupt	corruption
coruscate	coruscation
cost	cost
cough	cough
counteract	counteraction
counterattack	counterattack
counterclaim	counterclaim
counter	counter
countermand	countermand
countermine	countermine
counterpoint	counterpoint
countersign	countersign
country-dance	country-dance
court	court
court-martial	court-martial
covenant	covenant
cover	cover
crack	crack
crackle	crackle
crash	crash
crawl	crawl
craze	craze
creak	creak
create	creation
credit	credit
creep	creep
cremate	cremation
crenelate	crenelation
crenellate	crenellation
crepitate	crepitation
crescendo	crescendo
crick	crick
cricket	cricket
critique	critique
croak	croak
crop	crop
croquet	croquet
cross	cross
cross_examine	cross-examination
cross-fertilise	cross-fertilisation
cross-fertilize	cross-fertilization
cross-pollinate	cross-pollination
cross_question	cross-question
crouch	crouch
crow	crow
crowd	crowd
crucify	crucifixion
cruise	cruise
crunch	crunch
crusade	crusade
crush	crush
cry	cry
crystallise	crystallisation
crystallize	crystallization
cuddle	cuddle
culminate	culmination
cultivate	cultivation
curb	curb
curse	curse
curtsey	curtsey
curtsy	curtsy
curvet	curvet
cuss	cuss
cybernate	cybernation
cycle	cycle
dab	dab
dally	dalliance
damage	damage
damn	damnation
dance	dance
dare	dare
dart	dart
dash	dash
date	date
dawn	dawn
daydream	daydream
daze	daze
deactivate	deactivation
deal	deal
deaminate	deamination
deaminize	deaminization
debar	debarment
debark	debarkation
debase	debasement
debate	debate
debauch	debauch
debilitate	debilitation
debit	debit
debut	debut
decalcify	decalcification
decamp	decampment
decarboxylate	decarboxylation
decay	decay
decease	decease
deceive	deception
decelerate	deceleration
decentralise	decentralisation
decentralize	decentralization
decide	decision
decimalise	decimalisation
decimalize	decimalization
decimate	decimation
decipher	decipherment
declaim	declamation
declassify	declassification
decline	declension
decline	declination
decline	decline
decolonise	decolonisation
decolonize	decolonization
decompose	decomposition
decompress	decompression
decontaminate	decontamination
decorate	decoration
decrease	decrease
decrescendo	decrescendo
dedicate	dedication
dedifferentiate	dedifferentiation
deduct	deduction
de-escalate	de-escalation
deface	defacement
defalcate	defalcation
defame	defamation
default	default
defeat	defeat
defecate	defecation
defect	defection
defend	defence
defenestrate	defenestration
defer	deference
defer	deferment
defer	deferral
defervesce	defervescence
defibrillate	defibrillation
defile	defilement
deflagrate	deflagration
deflate	deflation
deflect	deflection
deflect	deflexion
deflower	defloration
defoliate	defoliation
deforest	deforestation
deform	deformation
defray	defrayal
defray	defrayment
defy	defiance
degenerate	degeneration
degrade	degradation
degust	degustation
dehisce	dehiscence
dehumanise	dehumanisation
dehumanize	dehumanization
dehydrate	dehydration
deify	deification
de-iodinate	de-iodination
deject	dejection
delay	delay
delegate	delegation
delete	deletion
deliberate	deliberation
delight	delight
delineate	delineation
deliver	deliverance
delude	delusion
deluge	deluge
demagnetise	demagnetisation
demagnetize	demagnetization
demand	demand
demarcate	demarcation
demineralise	demineralisation
demineralize	demineralization
demobilise	demobilisation
demobilize	demobilization
demo	demo
demodulate	demodulation
demolish	demolition
demonetise	demonetisation
demonetize	demonetization
demonstrate	demonstration
demoralise	demoralisation
demoralize	demoralization
demote	demotion
demur	demur
demur	demurral
demythologise	demythologisation
demythologize	demythologization
denationalise	denationalisation
denationalize	denationalization
denazify	denazification
denigrate	denigration
denominate	denomination
denote	denotation
denounce	denouncement
denude	denudation
deny	denial
depersonalise	depersonalisation
depersonalize	depersonalization
depict	depiction
depilate	depilation
deplete	depletion
deploy	deployment
depolarise	depolarisation
depolarize	depolarization
depopulate	depopulation
deport	deportation
deport	deportment
depose	deposition
deposit	deposit
deposit	deposition
deprecate	deprecation
depreciate	depreciation
depress	depression
deprive	deprivation
depute	deputation
deracinate	deracination
derail	derailment
derange	derangement
deregulate	deregulation
deride	derision
derive	derivation
derogate	derogation
desalinate	desalination
desalinise	desalinisation
desalinize	desalinization
describe	description
desecrate	desecration
desegregate	desegregation
desensitise	desensitisation
desensitize	desensitization
desert	desertion
desiccate	desiccation
designate	designation
design	design
desire	desire
desolate	desolation
desorb	desorption
despair	despair
despair	desperation
despatch	despatch
despise	despisal
despoil	despoilment
despoil	despoliation
despond	despondence
desquamate	desquamation
destabilise	destabilisation
destabilize	destabilization
destalinise	destalinisation
destalinize	destalinization
destroy	destruction
detach	detachment
detail	detail
detain	detention
detect	detection
deter	determent
deter	deterrence
deteriorate	deterioration
determine	determination
determine	determiner
detest	detestation
dethrone	dethronement
detonate	detonation
detoxify	detoxification
detract	detraction
detribalise	detribalisation
detribalize	detribalization
devaluate	devaluation
devalue	devaluation
devastate	devastation
develop	development
deviate	deviation
devil	devilment
devise	devisal
devitalise	devitalisation
devitalize	devitalization
devolve	devolution
devolve	devolvement
devote	devotion
diagonalise	diagonalisation
diagonalize	diagonalization
dichotomise	dichotomisation
dichotomize	dichotomization
dictate	dictate
dictate	dictation
diet	diet
differ	difference
differentiate	difference
differentiate	differentiation
diffract	diffraction
diffuse	diffusion
dig	dig
digest	digestion
digitalize	digitalization
digitise	digitisation
digitize	digitization
digress	digression
dilapidate	dilapidation
dilate	dilatation
dilate	dilation
dilute	dilution
diminish	diminution
din	din
dine	dinner
dip	dip
disable	disablement
disaffect	disaffection
disambiguate	disambiguation
disappear	disappearance
disappoint	disappointment
disapprove	disapproval
disarm	disarmament
disarrange	disarrangement
disarray	disarray
disassociate	disassociation
disavow	disavowal
disband	disbandment
disbar	disbarment
disburse	disbursal
disburse	disbursement
discard	discard
discern	discernment
discharge	discharge
discipline	discipline
discolor	discoloration
discolour	discolouration
discombobulate	discombobulation
disconcert	disconcertion
disconcert	disconcertment
disconnect	disconnection
discontent	discontent
discontent	discontentment
discontinue	discontinuance
discontinue	discontinuation
discord	discord
discord	discordance
discount	discount
discourage	discouragement
discourse	discourse
discredit	discredit
discriminate	discrimination
discuss	discussion
disdain	disdain
disembark	disembarkation
disembark	disembarkment
disenchant	disenchantment
disenfranchise	disenfranchisement
disengage	disengagement
disentangle	disentanglement
disestablish	disestablishment
disesteem	disesteem
disfavor	disfavor
disfavour	disfavour
disfigure	disfigurement
disforest	disforestation
disfranchise	disfranchisement
disgorge	disgorgement
disgrace	disgrace
disgruntle	disgruntlement
disguise	disguise
disgust	disgust
dishearten	disheartenment
dishonor	dishonor
dishonour	dishonour
disillusion	disillusion
disillusion	disillusionment
disinfect	disinfection
disinfest	disinfestation
disinherit	disinheritance
disintegrate	disintegration
disinter	disinterment
disinvest	disinvestment
disjoin	disjunction
dislike	dislike
dislocate	dislocation
dislodge	dislodgement
dismantle	dismantlement
dismay	dismay
dismember	dismemberment
dismiss	dismissal
dismiss	dismission
dismount	dismount
disobey	disobedience
disorder	disorder
disorganise	disorganisation
disorganize	disorganization
disorient	disorientation
disown	disownment
disparage	disparagement
dispatch	dispatch
dispense	dispensation
disperse	dispersal
disperse	dispersion
dispose	disposal
dispose	disposition
dispossess	dispossession
dispute	disputation
dispute	dispute
disqualify	disqualification
disquiet	disquiet
disregard	disregard
disrespect	disrespect
disrupt	disruption
dissatisfy	dissatisfaction
dissect	dissection
disseminate	dissemination
dissent	dissension
dissent	dissent
dissertate	dissertation
dissimilate	dissimilation
dissimulate	dissimulation
dissipate	dissipation
dissociate	dissociation
dissolve	dissolution
dissolve	dissolve
dissonate	dissonance
dissuade	dissuasion
distance	distance
distemper	distemper
distend	distension
distend	distention
distill	distillation
distill	distillment
distinguish	distinction
distort	distortion
distract	distraction
distress	distress
distribute	distribution
distrust	distrust
disturb	disturbance
disunite	disunion
dither	dither
divagate	divagation
dive	dive
diverge	divergence
diversify	diversification
divert	diversion
divide	division
divorce	divorce
divorce	divorcement
divulge	divulgement
divulge	divulgence
document	document
dodge	dodge
dogfight	dogfight
dominate	dominance
dominate	domination
dominate	dominion
donate	donation
doom	doom
double_cross	double_cross
double	double
doubt	doubt
douche	douche
dowse	dowse
doze	doze
draft	draft
drag	drag
drain	drain
dramatise	dramatisation
dramatize	dramatization
draw	draw
dread	dread
dream	dream
dribble	dribble
drift	drift
drill	drill
drink	drink
drive	drive
drizzle	drizzle
drop	drop
dropkick	dropkick
drowse	drowse
drum	drum
duel	duel
dunk	dunk
duplicate	duplication
eagle	eagle
ease	ease
ease	easement
ebb	ebb
echo	echo
eclipse	eclipse
eddy	eddy
edge	edge
edify	edification
educate	education
efface	effacement
effect	effect
effectuate	effectuation
effervesce	effervescence
effloresce	efflorescence
effuse	effusion
egress	egress
egress	egression
ejaculate	ejaculation
eject	ejection
elaborate	elaboration
elate	elation
elect	election
electrify	electricity
electrify	electrification
electrocute	electrocution
elevate	elevation
elicit	elicitation
elide	elision
eliminate	elimination
elocute	elocution
elongate	elongation
elope	elopement
elucidate	elucidation
elude	elusion
elute	elution
emanate	emanation
emancipate	emancipation
emasculate	emasculation
embalm	embalmment
embark	embarkment
embarrass	embarrassment
embellish	embellishment
embezzle	embezzlement
embitter	embitterment
embody	embodiment
embrace	embrace
embroil	embroilment
emerge	emergence
emerge	emersion
emigrate	emigration
emit	emission
emote	emotion
emplace	emplacement
employ	employ
employ	employment
empower	empowerment
emulate	emulation
enact	enactment
encamp	encampment
encapsulate	encapsulation
encase	encasement
enchant	enchantment
encircle	encirclement
encompass	encompassment
encounter	encounter
encourage	encouragement
encroach	encroachment
encrust	encrustation
encrypt	encryption
endear	endearment
endeavor	endeavor
endeavour	endeavour
end	end
endorse	endorsement
endow	endowment
endure	endurance
enervate	enervation
enfeeble	enfeeblement
enforce	enforcement
enfranchise	enfranchisement
engage	engagement
engorge	engorgement
engross	engrossment
enjoin	injunction
enjoy	enjoyment
enlarge	enlargement
enlist	enlistment
ennoble	ennoblement
enrage	enragement
enrich	enrichment
enrol	enrolment
enroll	enrollment
enslave	enslavement
enter	entrance
enthrall	enthrallment
enthrone	enthronement
enthrone	enthronisation
enthrone	enthronization
entice	enticement
entomb	entombment
entrance	entrancement
enucleate	enucleation
enumerate	enumeration
enunciate	enunciation
envelop	envelopment
envy	envy
equalise	equalisation
equalize	equalization
equate	equation
equivocate	equivocation
eradicate	eradication
erect	erection
erode	erosion
err	error
eruct	eructation
erupt	eruption
escalade	escalade
escalate	escalation
escape	escape
espouse	espousal
espy	espial
essay	essay
establish	establishment
esteem	esteem
estimate	estimation
estivate	estivation
estrange	estrangement
etiolate	etiolation
europeanise	europeanisation
europeanize	europeanization
evacuate	evacuation
evade	evasion
evaluate	evaluation
evanesce	evanescence
evaporate	evaporation
evaporate	vapor
evert	eversion
evict	eviction
eviscerate	evisceration
evoke	evocation
evolve	evolution
exacerbate	exacerbation
exact	exaction
exaggerate	exaggeration
exalt	exaltation
examine	examination
exasperate	exasperation
excavate	excavation
except	exception
exchange	exchange
excise	excision
excite	excitation
excite	excitement
exclaim	exclamation
exclude	exclusion
excogitate	excogitation
excommunicate	excommunication
excoriate	excoriation
excrete	excretion
excruciate	excruciation
exculpate	exculpation
execrate	execration
execute	execution
exemplify	example
exemplify	exemplification
exempt	exemption
exenterate	exenteration
exercise	exercise
exert	exertion
exfoliate	exfoliation
exhale	exhalation
exhaust	exhaustion
exhibit	exhibition
exhilarate	exhilaration
exhort	exhortation
exhume	exhumation
exile	exile
exist	existence
exit	exit
exonerate	exoneration
expand	expansion
expatiate	expatiation
expatriate	expatriation
expect	expectation
expectorate	expectoration
expel	expulsion
experience	experience
experiment	experiment
experiment	experimentation
expiate	expiation
expire	expiration
explain	explanation
explicate	explication
explode	explosion
exploit	exploitation
explore	exploration
export	exportation
expose	expose
exposit	exposition
expostulate	expostulation
express	express
express	expression
expropriate	expropriation
expunge	expunction
expurgate	expurgation
extemporise	extemporisation
extemporize	extemporization
extend	extension
extenuate	extenuation
exteriorise	exteriorisation
exteriorize	exteriorization
extinguish	extinction
extirpate	extirpation
extort	extortion
extract	extraction
extradite	extradition
extrapolate	extrapolation
extravasate	extravasation
extricate	extrication
extrude	extrusion
exude	exudation
exult	exultation
fabricate	fabrication
face	face
facilitate	facilitation
factor	factorisation
factor	factorization
factorise	factorisation
factorize	factor
factorize	factorization
fade	fade
faint	faint
fall	fall
falsify	falsification
falsify	falsifying
falsify	falsity
falter	falter
familiarise	familiarisation
familiarize	familiarization
fare	fare
farrow	farrow
fart	fart
fascinate	fascination
fast	fast
fate	fate
fatigue	fatigue
fault	fault
favor	favor
favour	favour
fear	fear
feast	feast
feather	feather
fecundate	fecundation
federalise	federalisation
federalize	federalization
federate	federation
feel	feel
feint	feint
felicitate	felicitation
fellate	fellation
fell	fell
feminise	feminisation
feminize	feminization
ferment	ferment
ferment	fermentation
ferry	ferry
fertilize	fertilization
fester	fester
festinate	festination
fete	fete
feud	feud
fibrillate	fibrillation
fictionalise	fictionalisation
fictionalize	fictionalization
fidget	fidget
fight	fight
figure	figuration
filiate	filiation
filter	filtration
finalise	finalisation
finalize	finalization
finance	finance
find	find
finish	finish
fire	fire
fistfight	fistfight
fixate	fixation
fix	fix
flagellate	flagellation
flame	flame
flap	flap
flare	flare
flash	flash
flaunt	flaunt
flavor	flavor
flavour	flavour
flaw	flaw
flex	flex
flicker	flicker
flick	flick
flight	flight
flinch	flinch
fling	fling
flip	flip
flip-flop	flip-flop
flirt	flirt
flirt	flirtation
flit	flit
float	floatation
float	flotation
flocculate	flocculation
flood	flood
flop	flop
flounce	flounce
flourish	flourish
flow	flow
flub	flub
fluctuate	fluctuation
fluff	fluff
fluoresce	fluorescence
fluoridate	fluoridation
fluoridise	fluoridisation
fluoridize	fluoridization
flurry	flurry
flush	flush
fluster	fluster
flutter	flutter
flux	flux
flux	fluxion
focalise	focalisation
focalize	focalization
fog	fog
fold	fold
foliate	foliation
folk_dance	folk_dance
foment	fomentation
foot	foot
forage	forage
foray	foray
forbear	forbearance
forbid	forbiddance
force	force
ford	ford
forecast	forecast
forfeit	forfeit
fork	fork
formalise	formalisation
formalize	formalization
form	formation
formicate	formication
formulate	formulation
fornicate	fornication
fortify	fortification
fossilise	fossilisation
fossilize	fossilization
foul	foul
found	foundation
foxhunt	foxhunt
fractionate	fractionation
fracture	fracture
fragment	fragmentation
fraternise	fraternisation
fraternize	fraternization
frazzle	frazzle
freeze	freeze
freight	freight
fresco	fresco
fret	fret
fright	fright
frisk	frisk
frolic	frolic
frost	frost
frown	frown
fructify	fructification
fruit	fruition
frustrate	frustration
fuck	fuck
fulfil	fulfilment
fulfill	fulfillment
fulminate	fulmination
fumble	fumble
fumigate	fumigation
function	function
further	furtherance
fuse	fusion
fusillade	fusillade
fuss	fuss
gabble	gabble
gag	gag
gall	gall
gallop	gallop
galvanise	galvanisation
galvanize	galvanization
gamble	gamble
gambol	gambol
gape	gape
gargle	gargle
gasconade	gasconade
gash	gash
gasify	gasification
gasp	gasp
gather	gather
gauge	gauge
gaze	gaze
geminate	gemination
generalise	generalisation
generalize	generalization
generate	generation
gentrify	gentrification
genuflect	genuflection
genuflect	genuflexion
germinate	germination
gerrymander	gerrymander
gestate	gestation
gesticulate	gesticulation
get_together	get_together
gibber	gibber
gibe	gibe
gift	gift
giggle	giggle
glaciate	glaciation
glamorise	glamorisation
glamorize	glamor
glamorize	glamorization
glamourise	glamourisation
glamourize	glamourization
glance	glance
glare	glare
gleam	gleam
glide	glide
glimmer	glimmer
glimpse	glimpse
glint	glint
glissade	glissade
glitter	glitter
gloat	gloat
globalise	globalisation
globalize	globalization
glorify	glorification
glory	glory
gloss	gloss
glower	glower
glow	glow
gobble	gobble
go	go
golf	golf
goose_step	goose_step
gore	gore
gossip	gossip
gouge	gouge
govern	governance
govern	government
grab	grab
gradate	gradation
grade	gradation
graduate	graduation
graft	graft
grant	grant
granulate	granulation
grapple	grapple
grasp	grasp
gratify	gratification
gravitate	gravitation
graze	graze
grease	grease
grimace	grimace
grime	grime
grind	grind
grin	grin
gripe	gripe
grip	grip
groan	groan
grope	grope
growl	growl
grudge	grudge
grumble	grumble
grunt	grunt
guarantee	guarantee
guard	guard
guess	guess
guesstimate	guesstimate
guffaw	guffaw
guide	guidance
gulp	gulp
gun	gun
gurgle	gurgle
gush	gush
gyp	gyp
gyrate	gyration
haemagglutinate	haemagglutination
haggle	haggle
hail	hail
halloo	halloo
hallucinate	hallucination
halt	halt
ham	ham
hand	hand
handicap	handicap
hand_over	handover
hap	hap
harangue	harangue
harass	harassment
harbinger	harbinger
harm	harm
harmonise	harmonisation
harmonize	harmonization
harvest	harvest
hassle	hassle
hatch	hatch
hate	hate
haul	haul
hazard	hazard
haze	haze
head	head
heap	heap
heat	heat
heave	heave
heed	heed
hee-haw	hee-haw
heist	heist
help	help
hemagglutinate	hemagglutination
hemorrhage	hemorrhage
herald	herald
hesitate	hesitation
hibernate	hibernation
hiccough	hiccough
hiccup	hiccup
highjack	highjack
hijack	hijack
hike	hike
hint	hint
hiss	hiss
hitch	hitch
hit	hit
hobble	hobble
hold	hold
holiday	holiday
holler	holler
hollo	hollo
homer	homer
homogenise	homogenisation
homogenize	homogenization
honeymoon	honeymoon
honk	honk
honor	honor
honour	honour
hook	hook
hoot	hoot
hope	hope
hop	hop
horripilate	horripilation
hospitalise	hospitalisation
hospitalize	hospitalization
howl	howl
hugger_mugger	hugger-mugger
hug	hug
humanise	humanisation
humanize	humanization
humbug	humbug
hum	hum
humiliate	humiliation
hunch	hunch
hunger	hunger
hunt	hunt
hurdle	hurdle
hurl	hurl
hurry	hurry
hurt	hurt
hush	hush
hustle	hustle
hybridise	hybridisation
hybridize	hybridization
hydrate	hydration
hydrogenate	hydrogenation
hyperextend	hyperextension
hypertrophy	hypertrophy
hyperventilate	hyperventilation
hyphenate	hyphenation
hypostatise	hypostatisation
hypostatize	hypostatization
idealise	idealisation
idealize	idealization
ideate	ideation
identify	identification
idolise	idolisation
idolize	idolization
ignite	ignition
ignore	ignorance
ill-treat	ill-treatment
illuminate	illumination
illustrate	illustration
image	image
imagine	imagination
imbibe	imbibition
imbricate	imbrication
imitate	imitation
immerse	immersion
immigrate	immigration
immobilise	immobilisation
immobilize	immobilization
immolate	immolation
immunize	immunization
immure	immurement
impact	impact
impact	impaction
impair	impairment
impale	impalement
impart	impartation
impel	impulsion
impend	impendence
impersonate	impersonation
impinge	impingement
implant	implantation
implement	implementation
implicate	implication
implode	implosion
imply	implication
import	importation
impose	imposition
impound	impoundment
impoverish	impoverishment
imprecate	imprecation
impregnate	impregnation
impress	impress
impress	impression
impress	impressment
imprison	imprisonment
improve	improvement
improvise	improvisation
impute	imputation
inactivate	inactivation
inaugurate	inauguration
incandesce	incandescence
incarcerate	incarceration
incarnate	incarnation
incase	incasement
incinerate	incineration
incise	incision
incite	incitation
incite	incitement
incline	inclination
include	inclusion
inconvenience	inconvenience
incorporate	incorporation
increase	increase
incriminate	incrimination
incrust	incrustation
incubate	incubation
inculcate	inculcation
inculpate	inculpation
incur	incurrence
incur	incursion
incurvate	incurvation
indemnify	indemnification
indemnify	indemnity
indent	indentation
indicate	indication
indict	indictment
indispose	indisposition
individualise	individualisation
individualize	individualization
individuate	individuation
indoctrinate	indoctrination
indorse	indorsement
induce	inducement
induce	induction
induct	induction
indulge	indulgence
indurate	induration
industrialise	industrialisation
industrialize	industrialization
indwell	indweller
inebriate	inebriation
infatuate	infatuation
infect	infection
infer	inference
infest	infestation
infiltrate	infiltration
inflame	inflammation
inflate	inflation
inflect	inflection
inflect	inflexion
inflict	infliction
influence	influence
infract	infraction
infringe	infringement
infuriate	infuriation
infuse	infusion
ingest	ingestion
inhabit	inhabitation
inhale	inhalation
inhere	inherence
inherit	inheritance
inhibit	inhibition
inhume	inhumation
initiate	initiation
inject	injection
innervate	innervation
innovate	innovation
inoculate	inoculation
inosculate	inosculation
inscribe	inscription
inseminate	insemination
insert	insertion
insinuate	insinuation
insist	insistence
insolate	insolation
inspect	inspection
inspire	inspiration
inspissate	inspissation
instal	instalment
install	installation
install	installment
instance	instance
instantiate	instance
instantiate	instantiation
instigate	instigation
instil	instilment
instill	instillation
instill	instillment
institute	institution
instruct	instruction
instrument	instrument
instrument	instrumentation
insufflate	insufflation
insulate	insulation
insult	insult
integrate	integration
intend	intention
intensify	intensification
interact	interaction
intercede	intercession
intercept	interception
interchange	interchange
intercommunicate	intercommunication
interconnect	interconnection
interdepend	interdependence
interdict	interdict
interdict	interdiction
interest	interest
interfere	interference
inter	interment
interject	interjection
interlock	interlock
interlude	interlude
intermediate	intermediation
intermit	intermission
internationalise	internationalisation
internationalize	internationalization
intern	internment
interpellate	interpellation
interpenetrate	interpenetration
interpolate	interpolation
interpose	interposition
interpret	interpretation
interrelate	interrelation
interrogate	interrogation
interrupt	interruption
intersect	intersection
intersperse	interspersal
intersperse	interspersion
intervene	intervention
interview	interview
intimate	intimation
intimidate	intimidation
intonate	intonation
intone	intonation
intoxicate	intoxication
introduce	introduction
introject	introjection
intromit	intromission
introspect	introspection
introvert	introversion
intrude	intrusion
intubate	intubation
intuit	intuition
intumesce	intumescence
intussuscept	intussusception
inunct	inunction
inundate	inundation
invade	invasion
invaginate	invagination
invalidate	invalidation
invent	invention
invert	inversion
investigate	investigation
invest	investment
invigilate	invigilation
invigorate	invigoration
invite	invitation
invite	invite
invoke	invocation
involve	involution
involve	involvement
iodise	iodination
iodize	iodination
ionise	ionisation
ionize	ionization
irradiate	irradiation
irrigate	irrigation
irritate	irritation
irrupt	irruption
isolate	isolation
isomerise	isomerisation
isomerize	isomerization
issue	issue
itch	itch
itemise	itemisation
itemize	itemization
iterate	iteration
jabber	jabber
jab	jab
jackknife	jackknife
jactitate	jactitation
jam	jam
jangle	jangle
jar	jar
jaundice	jaundice
jaunt	jaunt
jeer	jeer
jerk	jerk
jest	jest
jet	jet
jiggle	jiggle
jig	jig
jingle	jingle
jitterbug	jitterbug
jive	jive
job	job
joggle	joggle
jog	jog
join	junction
joke	joke
jollify	jollification
jolly	jolly
jolt	jolt
jostle	jostle
journey	journey
joust	joust
joy	joy
joyride	joyride
jubilate	jubilation
jubilate	jubilee
judge	judge
judge	judgment
juggle	juggle
jumble	jumble
jump	jump
junket	junket
justify	justification
juxtapose	juxtaposition
keen	keen
keratinise	keratinisation
keratinize	keratinization
kick	kick
kill	kill
kip	kip
kiss	kiss
kneel	kneel
knell	knell
knock	knock
kowtow	kowtow
labor	labor
labour	labour
lacerate	laceration
lack	lack
lactate	lactation
lag	lag
lament	lament
lament	lamentation
laminate	lamination
lam	lam
lampoon	lampoon
lapidate	lapidation
lap	lap
lapse	lapse
lark	lark
lash	lash
laugh	laugh
launch	launch
lave	lavation
lay_over	layover
leach	leach
lead	lead
leak	leak
lean	leaner
leapfrog	leapfrog
leap	leap
lease	lease
leave	leave
lecture	lecture
leer	leer
legalise	legalisation
legalize	legalization
legislate	legislation
legitimate	legitimation
leverage	leverage
levitate	levitation
levy	levy
lexicalize	lexicalization
libel	libel
liberalise	liberalisation
liberalize	liberalization
liberate	liberation
librate	libration
licence	licence
license	license
lick	lick
lie	lie
lift	lift
ligate	ligation
light	light
limit	limit
limit	limitation
limp	limp
line	line
line	lineation
link	link
liquefy	liquefaction
liquidate	liquidation
lisp	lisp
litigate	litigation
loan	loan
lob	lob
localise	localisation
localize	localization
locate	location
lock	lock
locomote	locomotion
lodge	lodgement
look	look
loop	loop
lope	lope
love	love
lubricate	lubrication
luff	luff
lull	lull
luminesce	luminescence
lunch	lunch
lunge	lunge
lurch	lurch
lust	lust
luxate	luxation
lyophilise	lyophilisation
lyophilize	lyophilization
lysogenize	lysogenization
macerate	maceration
maculate	maculation
magnetise	magnetisation
magnetize	magnetization
magnify	magnification
maintain	maintenance
make_over	makeover
maledict	malediction
malfunction	malfunction
malign	malignment
maltreat	maltreatment
malversate	malversation
manage	management
mandate	mandate
maneuver	maneuver
manicure	manicure
manifest	manifestation
manipulate	manipulation
manoeuvre	manoeuvre
manufacture	manufacture
manumit	manumission
map	map
maraud	maraud
march	march
marginalise	marginalisation
marginalize	marginalization
market	market
marvel	marvel
masculinize	masculinization
mask	mask
masquerade	masquerade
massacre	massacre
massage	massage
masticate	mastication
masturbate	masturbation
match	match
mate	mate
materialise	materialisation
materialize	materialization
matriculate	matriculation
matter	matter
maturate	maturation
mature	maturation
mature	maturement
maximise	maximisation
maximize	maximization
meander	meander
measure	measure
measure	measurement
mechanise	mechanisation
mechanize	mechanization
mediate	mediation
medicate	medication
medicine	medicine
meditate	meditation
meet	meet
meld	meld
meliorate	melioration
melt	melt
memorialise	memorialisation
memorialize	memorialization
memorise	memorisation
memorize	memorization
mend	mend
menstruate	menstruation
mensurate	mensuration
mention	mention
meow	meow
merge	merger
mesh	mesh
mess	mess
metricate	metrication
metrify	metrification
mew	mew
miaou	miaou
miaow	miaow
micturate	micturition
miff	miff
migrate	migration
mildew	mildew
militarise	militarisation
militarize	militarization
mill	mill
mime	mime
mind	mind
mine	mine
miniaturise	miniaturisation
miniaturize	miniaturization
minimise	minimisation
minimize	minimization
minister	ministration
misally	misalliance
misapply	misapplication
misapprehend	misapprehension
misappropriate	misappropriation
misbehave	misbehavior
miscalculate	miscalculation
miscegenate	miscegenation
misconceive	misconception
misconduct	misconduct
misconstrue	misconstrual
miscount	miscount
misdeal	misdeal
misestimate	misestimation
misfire	misfire
misinterpret	misinterpretation
misplay	misplay
misprint	misprint
mispronounce	mispronunciation
misquote	misquotation
misrepresent	misrepresentation
miss	miss
mistake	mistake
mistranslate	mistranslation
mistreat	mistreatment
mistrust	mistrust
misuse	misuse
mitigate	mitigation
mix	mix
mizzle	mizzle
moan	moan
mobilise	mobilisation
mobilize	mobilization
mob	mob
mock	mock
model	model
moderate	moderation
modernise	modernisation
modernize	modernization
modify	modification
modulate	modulation
mold	mold
molest	molestation
mollify	mollification
molt	molt
monetise	monetisation
monetize	monetization
monopolise	monopolisation
monopolize	monopolization
moo	moo
mop_up	mop_up
moralise	moralisation
moralize	moralization
mortify	mortification
motivate	motivation
motivate	motivator
motorise	motorisation
motorize	motorization
moult	moult
mount	mount
mouth	mouth
move	motion
move	move
move	movement
muddle	muddle
muff	muff
mulct	mulct
multiply	multiplication
mummify	mummification
munch	munch
murder	murder
murk	murk
murmur	murmur
murmur	murmuration
mussitate	mussitation
muss	muss
muster	muster
mutate	mutation
mutilate	mutilation
mutiny	mutineer
mutiny	mutiny
mutter	mutter
mystify	mystification
mythologise	mythologisation
mythologize	mythologization
nap	nap
narrate	narration
nasalise	nasalisation
nasalize	nasalization
nationalise	nationalisation
nationalize	nationalization
naturalise	naturalisation
naturalize	naturalization
navigate	navigation
need	need
negate	negation
negative	negative
neglect	neglect
negotiate	negotiation
neigh	neigh
nestle	nestle
neutralise	neutralisation
neutralize	neutralization
nibble	nibble
nicker	nicker
nick	nick
nictate	nictation
nictitate	nictitation
nip	nip
nitrify	nitrification
nod	nod
noise	noise
nominate	nomination
normalise	normalisation
normalize	normalization
nose	nose
nosh	nosh
notate	notation
note	note
notice	notice
notify	notice
notify	notification
nourish	nourishment
novate	novation
novelise	novelisation
novelize	novelization
nudge	nudge
nullify	nullification
number	number
numerate	numeration
nurture	nurture
nutate	nutation
nutrify	nutrition
obey	obedience
obey	obeisance
obfuscate	obfuscation
objectify	objectification
object	objection
objurgate	objurgation
obligate	obligation
obliterate	obliteration
observe	observance
observe	observation
obsess	obsession
obsolesce	obsolescence
obstinate	obstinance
obstipate	obstipation
obstruct	obstruction
obtain	obtainment
obtain	obtention
obviate	obviation
occasion	occasion
occlude	occlusion
occupy	occupation
offend	offence
offer	offer
officiate	officiation
ooze	ooze
opacify	opacification
open	opener
operate	operation
opine	opinion
oppose	opposition
oppress	oppression
opsonize	opsonisation
opsonize	opsonization
optimise	optimisation
optimize	optimization
opt	option
orbit	orbit
orchestrate	orchestration
ordain	ordinance
order	order
organise	organisation
organize	organization
originate	origination
ornament	ornamentation
oscillate	oscillation
osculate	osculation
ossify	ossification
ostentate	ostentation
outcry	outcry
output	output
outrage	outrage
overachieve	overachievement
overbid	overbid
overcapitalise	overcapitalisation
overcapitalize	overcapitalization
overcast	overcast
overcharge	overcharge
overcompensate	overcompensation
overdrive	overdrive
overestimate	overestimate
overestimate	overestimation
overexert	overexertion
overexploit	overexploitation
overflow	overflow
overhaul	overhaul
overindulge	overindulgence
overlap	overlap
overpay	overpayment
overpopulate	overpopulation
overproduce	overproduction
overprotect	overprotection
overreact	overreaction
overrefine	overrefinement
override	override
overrun	overrun
overshoot	overshoot
oversimplify	oversimplification
overstate	overstatement
overstrain	overstrain
overthrow	overthrow
overturn	overturn
overuse	overuse
overvalue	overvaluation
overwork	overwork
ovulate	ovulation
oxidate	oxidation
oxidise	oxidisation
oxidize	oxidization
oxygenate	oxygenation
pace	pace
pacify	pacification
pacify	peace
paginate	pagination
pain	pain
pair	pair
palaver	palaver
palliate	palliation
pall	pall
palpate	palpation
palpebrate	palpebration
palpitate	palpitation
palsy	palsy
panic	panic
pantomime	pantomime
pant	pant
parade	parade
paragraph	paragraph
paraphrase	paraphrase
parcel	parcellation
pardon	pardon
parley	parley
parody	parody
parole	parole
par	par
parry	parry
participate	participation
particularise	particularisation
particularize	particularization
partition	partition
party	party
pass	pass
pasteurise	pasteurisation
pasteurize	pasteurization
pat	pat
patrol	patrol
patronage	patronage
pattern	pattern
patter	patter
pauperise	pauperisation
pauperize	pauperization
pause	pause
pawn	pawn
pay	payment
peak	peak
peal	peal
peculate	peculation
pedal	pedal
pedicure	pedicure
peek	peek
pee	pee
peep	peep
penalise	penalisation
penalize	penalization
penetrate	penetration
pension	pension
peptise	peptisation
peptize	peptization
perambulate	perambulation
perceive	perception
percolate	percolation
percuss	percussion
peregrinate	peregrination
perennate	perennation
perfect	perfection
perforate	perforation
perform	performance
perfuse	perfusion
peril	peril
permeate	permeation
permit	permission
permit	permit
permute	permutation
perorate	peroration
perpetrate	perpetration
perpetuate	perpetuation
persecute	persecution
perseverate	perseveration
persevere	perseverance
persevere	perseveration
persist	persistence
personate	personation
personify	persona
personify	personification
perspire	perspiration
persuade	persuasion
perturb	perturbation
peruse	perusal
pervade	pervasion
pervaporate	pervaporation
pervert	perversion
petition	petition
petrify	petrifaction
petrify	petrification
phase	phase
phonate	phonation
phosphoresce	phosphorescence
pick	pick
picnic	picnic
piffle	piffle
pigment	pigmentation
pinch	pinch
ping	ping
pique	pique
pitch	pitch
pitter-patter	pitter-patter
pity	pity
pivot	pivot
placate	placation
place	place
plagiarise	plagiarisation
plagiarize	plagiarization
plague	plague
plane	planation
plash	plash
plastinate	plastination
play	play
pledge	pledge
plicate	plication
plight	plight
plonk	plonk
plop	plop
plot	plot
pluck	pluck
plug	plug
plump	plump
plunge	plunge
plunk	plunk
poise	poise
poke	poke
polarise	polarisation
polarize	polarization
polish	polish
pollenate	pollenation
pollinate	pollination
poll	poll
pollute	pollution
polymerise	polymerisation
polymerize	polymerization
pool	pool
pop	pop
popularise	popularisation
popularize	popularization
populate	population
portray	portrayal
pose	pose
position	position
posit	position
possess	possession
postpone	postponement
postpose	postposition
post	post
postulate	postulation
posture	posture
potentiate	potentiation
pother	pother
pounce	pounce
pound	pound
pout	pout
power	power
powwow	powwow
practice	practice
praise	praise
prance	prance
prate	prate
prattle	prattle
pray	prayer
preachify	preachification
preamble	preamble
precede	precedence
precede	precession
precipitate	precipitation
precis	precis
preclude	preclusion
precondition	precondition
predate	predation
predestine	predestination
predetermine	predetermination
predicate	predication
predict	prediction
predominate	predominance
predominate	predomination
preempt	preemption
preexist	preexistence
prefabricate	prefabrication
prefer	preference
prefer	preferment
prefigure	prefiguration
prefix	prefixation
prehend	prehension
prejudge	prejudgement
premeditate	premeditation
premiere	premiere
preoccupy	preoccupation
prepare	preparation
prepay	prepayment
prepose	preposition
prepossess	prepossession
present	presentation
present	presentment
preserve	preservation
press	press
pressure	pressure
presume	presumption
presuppose	presupposition
pretend	pretend
pretend	pretension
pretermit	pretermission
prevaricate	prevarication
prevent	prevention
preview	preview
previse	prevision
prick	prick
pride	pride
prizefight	prizefight
probate	probate
probate	probation
probe	probe
proceed	procession
process	process
proclaim	proclamation
procrastinate	procrastination
procreate	procreation
procure	procural
procure	procurance
procure	procurement
produce	production
profane	profanation
professionalize	professionalization
profess	profession
proffer	proffer
profit	profit
prognosticate	prognostication
progress	progress
progress	progression
prohibit	prohibition
project	project
project	projection
prolapse	prolapse
proliferate	proliferation
prolong	prolongation
promenade	promenade
promise	promise
promote	promotion
prompt	prompt
promulgate	promulgation
pronate	pronation
pronounce	pronouncement
propagate	propagation
propel	propulsion
propitiate	propitiation
propose	proposal
propose	proposition
proposition	proposition
prorate	proration
prorogue	prorogation
proscribe	proscription
prosecute	prosecution
prospect	prospect
prostitute	prostitution
prostrate	prostration
protect	protection
protest	protest
protest	protestation
protract	protraction
protrude	protrusion
provide	provision
provision	provision
provoke	provocation
prowl	prowl
publish	publication
puff	puff
pull	pull
pullulate	pullulation
pulsate	pulsation
pulse	pulse
pulverise	pulverisation
pulverize	pulverization
punch	punch
punctuate	punctuation
puncture	puncture
punish	punishment
pun	pun
punt	punt
purchase	purchase
purge	purgation
purge	purge
purify	purification
purl	purl
purpose	purpose
purr	purr
pursue	pursuance
purvey	purveyance
push_back	push_back
push	push
putrefy	putrefaction
putt	putt
puzzle	puzzle
quack	quack
quaff	quaff
quake	quake
qualify	qualification
qualify	qualifying
quantify	quantification
quantise	quantisation
quantize	quantization
quarantine	quarantine
quarrel	quarrel
quaver	quaver
query	query
question	question
quest	quest
quibble	quibble
quickstep	quickstep
quiet	quiet
quip	quip
quiver	quiver
quiz	quiz
quote	quotation
quote	quote
race	race
racket	racket
rack	rack
radiate	radiance
radiate	radiation
raffle	raffle
rage	rage
rag	rag
raid	raid
rain	rain
raise	raise
rally	rally
ramble	ramble
ramify	ramification
rampage	rampage
randomise	randomisation
randomize	randomization
range	range
ransom	ransom
rant	rant
rape	rape
rap	rap
rarefy	rarefaction
rasp	rasp
ratify	ratification
ratiocinate	ratiocination
rationalise	rationalisation
rationalize	rationalization
ration	ration
rattle	rattle
ravage	ravage
ravel	ravel
rave	rave
ravish	ravishment
ray	ray
reabsorb	reabsorption
reach	reach
react	reaction
readjust	readjustment
readmit	readmission
ready	ready
reaffirm	reaffirmation
re-afforest	re-afforestation
realise	realisation
realize	realization
reallocate	reallocation
reallot	reallotment
reappear	reappearance
reapportion	reapportionment
reappraise	reappraisal
rearm	rearmament
rearrange	rearrangement
reason	reason
reassert	reassertion
reassess	reassessment
reassign	reassignment
reassure	reassurance
rebate	rebate
rebel	rebellion
rebound	rebound
rebuff	rebuff
rebuke	rebuke
rebury	reburial
rebut	rebuttal
recalculate	recalculation
recall	recall
recant	recantation
recapitulate	recapitulation
recap	recap
recapture	recapture
recede	recession
receipt	receipt
receive	reception
recess	recess
reciprocate	reciprocation
recite	recital
recite	recitation
reclaim	reclamation
recognize	recognition
recoil	recoil
recollect	recollection
recombine	recombination
recommence	recommencement
recompense	recompense
reconcile	reconciliation
reconnoiter	reconnaissance
reconnoitre	reconnaissance
reconsider	reconsideration
reconstruct	reconstruction
recount	recount
re-create	re-creation
recreate	recreation
recrudesce	recrudescence
recruit	recruitment
rectify	rectification
recuperate	recuperation
recur	recurrence
recuse	recusal
recuse	recusation
redact	redaction
rededicate	rededication
redeem	redemption
redefine	redefinition
redeploy	redeployment
redeposit	redeposition
redetermine	redetermination
redevelop	redevelopment
redispose	redisposition
redistribute	redistribution
redress	redress
reduce	reduction
reek	reek
reelect	reelection
reenforce	reenforcement
reevaluate	reevaluation
reexamine	reexamination
refer	reference
refer	referral
refine	refinement
reflate	reflation
reforest	reforestation
reform	reform
reform	reformation
refract	refraction
refresh	refreshment
refrigerate	refrigeration
refund	refund
refurbish	refurbishment
refuse	refusal
refute	refutation
regard	regard
regenerate	regeneration
regiment	regimentation
register	registration
regress	regress
regress	regression
regret	regret
regularise	regularisation
regularize	regularization
regulate	regulation
regurgitate	regurgitation
rehabilitate	rehabilitation
rehearse	rehearsal
reify	reification
reign	reign
reimpose	reimposition
reincarnate	reincarnation
reinforce	reinforcement
reinstate	reinstatement
reinsure	reinsurance
reinterpret	reinterpretation
reintroduce	reintroduction
reiterate	reiteration
reject	rejection
rejuvenate	rejuvenation
relapse	relapse
relate	relation
relax	relaxation
relay	relay
release	release
relegate	relegation
relinquish	relinquishment
relish	relish
relocate	relocation
rely	reliance
remake	remake
remand	remand
remark	remark
remediate	remediation
remedy	remedy
remember	remembrance
remilitarise	remilitarisation
remilitarize	remilitarization
reminisce	reminiscence
remit	remission
remit	remit
remit	remitment
remit	remittal
remit	remittance
remove	remotion
remove	removal
remunerate	remuneration
render	rendition
rendezvous	rendezvous
renege	renege
renew	renewal
renounce	renouncement
renounce	renunciation
renovate	renovation
rent	rent
rent	rental
reorganize	reorganization
reorient	reorientation
repair	repair
repair	reparation
repatriate	repatriation
repay	repayment
repeal	repeal
repeat	repeat
repeat	repetition
repent	repentance
replace	replacement
replay	replay
replenish	replenishment
replete	repletion
replicate	replication
reply	reply
report	report
repose	repose
reposit	reposition
repossess	repossession
reprehend	reprehension
represent	representation
repress	repression
reprieve	reprieve
reprimand	reprimand
reprint	reprint
reprobate	reprobation
reproduce	reproduction
reproof	reproof
reprove	reproval
republish	republication
repudiate	repudiation
repugn	repugnance
repulse	repulse
repulse	repulsion
repurchase	repurchase
repute	reputation
request	request
require	requisition
requisition	requisition
requite	requital
rerun	rerun
rescind	recission
rescind	rescission
rescue	rescue
research	research
resect	resection
resemble	resemblance
resent	resentment
reserve	reservation
resettle	resettlement
reship	reshipment
reshuffle	reshuffle
reside	residence
resign	resignation
resile	resilience
resist	resistance
resolve	resolution
resolve	resolve
resonate	resonance
resorb	resorption
resort	resort
respect	respect
respire	respiration
respite	respite
resplend	resplendence
restitute	restitution
restore	restoration
rest	rest
restrict	restriction
result	result
resume	resumption
resurge	resurgence
resurrect	resurrection
resuscitate	resuscitation
resuspend	resuspension
retail	retail
retain	retention
retake	retake
retaliate	retaliation
retard	retardation
retch	retch
rethink	rethink
reticulate	reticulation
retire	retirement
retort	retort
retract	retraction
retrench	retrenchment
retrieve	retrieval
retroflex	retroflection
retroflex	retroflexion
retrogress	retrogression
retrospect	retrospect
retrospect	retrospection
retrovert	retroversion
retry	retrial
return	return
reunify	reunification
reunify	reunion
reunite	reunion
revalue	revaluation
reveal	revelation
revel	revel
revenge	revenge
reverberate	reverberation
reverence	reverence
revere	reverence
reverse	reversal
reverse	reverse
revert	reversion
review	review
revise	revisal
revise	revise
revise	revision
revitalise	revitalisation
revitalize	revitalization
revive	revival
revivify	revivification
revoke	revocation
revoke	revoke
revolt	revolt
revolutionise	revolution
revolutionize	revolution
revolve	revolution
reward	reward
rhumba	rhumba
rhyme	rhyme
rib	rib
rick	rick
ricochet	ricochet
riddle	riddle
ride	ride
ridicule	ridicule
rid	riddance
riffle	riffle
riff	riff
right	right
rigidify	rigidification
rigidify	rigidifying
rig	rig
rime	rime
ring	ring
rinse	rinse
riot	riot
riposte	riposte
ripple	ripple
rip	rip
rise	rise
risk	risk
ritualize	ritual
roar	roar
roast	roast
rock	rock
roll_over	rollover
roll	roll
romance	romance
romanticise	romanticisation
romanticize	romanticization
romp	romp
rotate	rotation
rot	rot
round	round
rout	rout
row	row
rub	rub
rue	rue
ruff	ruff
ruggedise	ruggedisation
ruggedize	ruggedization
ruin	ruin
ruin	ruination
rule	rule
rumble	rumble
ruminate	rumination
rummage	rummage
rumor	rumor
rumour	rumour
rumpus	rumpus
run	run
rupture	rupture
rush	rush
rusticate	rustication
rustle	rustle
rust	rust
rut	rut
sabotage	sabotage
sack	sack
sacrifice	sacrifice
sail	sail
salaam	salaam
salivate	salivation
saltate	saltation
salute	salutation
salute	salute
salvage	salvage
salve	salvation
samba	samba
sample	sample
sanctify	sanctification
sanction	sanction
sanitate	sanitation
sanitise	sanitisation
sanitize	sanitization
saponify	saponification
sashay	sashay
satiate	satiation
satisfy	satisfaction
saturate	saturation
saunter	saunter
savor	savor
savour	savour
savvy	savvy
say	say
scald	scald
scamper	scamper
scam	scam
scandalise	scandal
scandalise	scandalisation
scandalize	scandal
scandalize	scandalization
scan	scan
scare	scare
scatter	scatter
scent	scent
schematise	schematisation
schematize	schematization
school	school
scintillate	scintillation
sclaff	sclaff
scoff	scoff
scorch	scorch
score	score
scowl	scowl
scrabble	scrabble
scramble	scramble
scrape	scrape
scrap	scrap
scrawl	scrawl
scream	scream
screech	screech
screw	screw
scribble	scribble
scrimmage	scrimmage
scrub	scrub
scrunch	scrunch
scruple	scruple
scud	scud
scuffle	scuffle
scuff	scuff
sculpture	sculpture
scurry	scurry
seal	seal
search	search
secede	secession
seclude	seclusion
second	second
second	secondment
secrete	secretion
sectionalise	sectionalisation
sectionalize	sectionalization
secularise	secularisation
secularize	secularization
sedate	sedation
sediment	sedimentation
seduce	seduction
segment	segmentation
segregate	segregation
select	selection
self-destroy	self-destruction
self-destruct	self-destruction
sell	sell
sense	sensation
sensitise	sensitisation
sensitize	sensitization
sentence	sentence
sentimentalise	sentimentalisation
sentimentalize	sentimentalization
separate	separation
sequence	sequence
sequester	sequestration
serenade	serenade
serialise	serialisation
serialize	serialization
serrate	serration
serve	serve
service	service
set	set
settle	settlement
sever	severance
sex	sex
shade	shade
shadow	shadow
shag	shag
shake	shake
shamble	shamble
shame	shame
shampoo	shampoo
shank	shank
shape	shape
share	share
shave	shave
shelter	shelter
shift	shift
shillyshally	shillyshally
shimmer	shimmer
shimmy	shimmy
ship	shipment
shipwreck	shipwreck
shirt	shirt
shit	shit
shiver	shiver
shock	shock
shoot	shoot
short	short
shout	shout
shove	shove
shower	shower
show	show
shriek	shriek
shrug	shrug
shudder	shudder
shuffle	shuffle
shy	shy
sibilate	sibilation
sigh	sigh
sight	sight
signalise	signalisation
signalize	signalization
signal	signal
sign	sign
silence	silence
simplify	simplification
simulate	simulation
singe	singe
single-foot	single-foot
single	single
singsong	singsong
sin	sin
sip	sip
sketch	sketch
skid	skid
skim	skim
skin-dive	skin-dive
skip	skip
skirl	skirl
skirmish	skirmish
skunk	skunk
slack	slack
slalom	slalom
slam_dance	slam_dance
slam	slam
slander	slander
slang	slang
slap	slap
slash	slash
slaughter	slaughter
sleep_over	sleepover
sleep	sleep
sleet	sleet
slice	slice
slide	slide
slight	slight
slip	slip
slumber	slumber
slump	slump
slur	slur
smack	smack
smack	smacker
smart	smart
smash	smash
smear	smear
smell	smell
smile	smile
smirch	smirch
smirk	smirk
smoke	smoke
smooch	smooch
smooth	smooth
smoulder	smoulder
smudge	smudge
smut	smut
snack	snack
snafu	snafu
snap	snap
snarl	snarl
snatch	snatch
sneer	sneer
sneeze	sneeze
snicker	snicker
snick	snick
sniffle	sniffle
sniff	sniff
snigger	snigger
snipe	snipe
snip	snip
snivel	snivel
snooker	snooker
snooze	snooze
snore	snore
snort	snort
snow	snow
snub	snub
snuffle	snuffle
snuff	snuff
snuggle	snuggle
soak	soak
soap	soap
soar	soar
sob	sob
socialise	socialisation
socialize	socialization
soil	soil
sojourn	sojourn
solace	solace
solarise	solarisation
solarize	solarization
solemnise	solemnisation
solemnize	solemnization
solicit	solicitation
solidify	solidification
solidify	solidifying
solmizate	solmization
solo	solo
solvate	solvation
solve	solution
somersault	somersault
somnambulate	somnambulation
sophisticate	sophistication
sorb	sorption
sorrow	sorrow
sort	sort
sound	sound
sour	sour
souse	souse
space	space
spank	spank
span	span
sparkle	sparkle
spark	spark
spat	spat
spatter	spatter
specialise	specialisation
specialize	specialization
speciate	speciation
specify	specification
speculate	speculation
speechify	speech
speed	speed
spell	spell
spiel	spiel
spike	spike
spill	spill
spin	spin
spiral	spiral
spirit	spirit
spiritualise	spiritualisation
spiritualize	spiritualization
spirt	spirt
spit	spit
splash	splash
splat	splat
splat	splatter
split	split
splurge	splurge
splutter	splutter
spoil	spoil
spoil	spoilation
spoil	spoliation
spoof	spoof
sport	sport
sporulate	sporulation
spotlight	spotlight
sprain	sprain
sprawl	sprawl
spray	spray
spread	spread
spree	spree
spring	spring
sprinkle	sprinkle
sprint	sprint
spritz	spritz
spurt	spurt
sputter	sputter
squabble	squabble
squall	squall
square_dance	square_dance
squat	squat
squawk	squawk
squeak	squeak
squeal	squeal
squeeze	squeeze
squelch	squelch
squint	squint
squirm	squirm
squirt	squirt
stabilise	stabilisation
stabilize	stabilization
stab	stab
stagger	stagger
stagnate	stagnation
stain	stain
stalemate	stalemate
stalinise	stalinisation
stalinize	stalinization
stalk	stalk
stall	stall
stammer	stammer
stampede	stampede
standardise	standardisation
standardize	standardization
stand	stance
stand	stand
stare	stare
startle	startle
start	start
starve	starvation
state	statement
stay	stay
steal	steal
stem	stem
step	step
sterilise	sterilisation
sterilize	sterilization
stew	stew
stigmatise	stigmatisation
stigmatize	stigmatization
still	still
stimulate	stimulation
sting	sting
sting	stinger
stink	stink
stipulate	stipulation
stir	stir
stomp	stomp
stoop	stoop
stop_over	stopover
stop	stop
storm	storm
straddle	straddle
strafe	strafe
straggle	straggle
strain	strain
strangle	strangulation
strangulate	strangulation
stratify	stratification
stream	stream
stress	stress
stretch	stretch
stride	stride
stridulate	stridulation
strike	strike
strip	strip
stroke	stroke
stroll	stroll
struggle	struggle
strum	strum
strut	strut
study	study
stultify	stultification
stumble	stumble
stunt	stunt
stupefy	stupefaction
stutter	stutter
stylise	stylisation
stylize	stylization
stymie	stymie
subdivide	subdivision
subject	subjection
subjoin	subjunction
subjugate	subjugation
sublimate	sublimation
subluxate	subluxation
submerge	submergence
submerge	submersion
submerse	submersion
submit	submission
subordinate	subordination
suborn	subornation
subrogate	subrogation
subscribe	subscription
subserve	subservience
subside	subsidence
subsidise	subsidisation
subsidize	subsidization
substantiate	substantiation
substitute	substitution
subsume	subsumption
subtitle	subtitle
subtract	subtraction
subvent	subvention
subvert	subversion
succeed	succession
succor	succor
succour	succour
succuss	succussion
suck	suck
suck	suction
suction	suction
sudate	sudation
suffer	sufferance
suffix	suffixation
suffocate	suffocation
suffuse	suffusion
suggest	suggestion
sulk	sulk
summarise	summarisation
summarize	summarization
summerize	summer
summer	summer
summons	summons
sum	summation
sunburn	sunburn
sun	sun
suntan	suntan
superannuate	superannuation
superfetate	superfetation
superinfect	superinfection
superintend	superintendence
superpose	superposition
superscribe	superscription
supersede	supersession
supervene	supervention
supervise	supervision
supinate	supination
supplement	supplementation
supplicate	supplication
supply	supply
support	support
suppose	supposal
suppose	supposition
suppress	suppression
suppurate	suppuration
sup	supper
surface	surface
surfeit	surfeit
surf	surf
surge	surge
surmise	surmisal
surmise	surmise
surprise	surprisal
surprise	surprise
surrender	surrender
survey	survey
survive	survival
suspect	suspicion
suspend	suspension
suspire	suspiration
sustain	sustainment
sustain	sustenance
susurrate	susurration
swagger	swagger
swallow	swallow
swap	swap
swash	swash
swat	swat
sway	sway
sweep	sweep
swerve	swerve
swig	swig
swim	swim
swindle	swindle
swing	swing
swipe	swipe
swirl	swirl
swish	swish
switch	switch
swoon	swoon
swoop	swoop
swop	swop
syllabicate	syllabication
syllabify	syllabification
symbolise	symbolisation
symbolize	symbolization
synchronise	synchronisation
synchronize	synchronization
syncopate	syncopation
syndicate	syndication
systematise	systematisation
systematize	systematization
taboo	taboo
tabulate	tabulation
tackle	tackle
tack	tack
tag	tag
taint	taint
take_over	takeover
take	take
talk	talk
tally	tally
tangle	tangle
tango	tango
tan	tan
tap_dance	tap_dance
taper	taper
tap	tap
tariff	tariff
tarnish	tarnish
tarry	tarriance
task	task
taste	taste
tattle	tattle
tattoo	tattoo
taunt	taunt
tax	taxation
tear	tear
tease	tease
telecast	telecast
telecommunicate	telecommunication
telephone	telephone
teleport	teleportation
televise	television
temper	temper
temper	temperance
tempt	temptation
tenderise	tenderisation
tenderize	tenderization
tender	tender
tense	tension
tergiversate	tergiversation
terminate	termination
terrify	terror
territorialise	territorialisation
territorialize	territorialization
terrorise	terror
terrorise	terrorisation
terrorize	terror
terrorize	terrorization
tessellate	tessellation
test_drive	test_drive
test	test
thaw	thaw
theorise	theorisation
theorize	theorization
think	think
thirst	thirst
thrash	thrash
thrill	thrill
throb	throb
throng	throng
throw	throw
thrum	thrum
thrust	thrust
thud	thud
thump	thump
thunder	thunder
thwack	thwack
tickle	tickle
tick	tick
ticktock	ticktock
tide	tide
tie	tie
tiller	tiller
tilt	tilt
time	time
tingle	tingle
ting	ting
tinkle	tinkle
tintinnabulate	tintinnabulation
titillate	titillation
titivate	titivation
titter	titter
tittivate	tittivation
tittle-tattle	tittle-tattle
toast	toast
toil	toil
tolerate	tolerance
tolerate	toleration
toll	toll
tonsure	tonsure
tootle	tootle
toot	toot
topicalize	topicalization
top	top
torment	torment
torture	torture
toss	toss
touch	touch
tourney	tourney
tour	tour
tow	tow
trade	trade
traduce	traducement
traffic	traffic
trample	trample
tramp	tramp
trance	trance
transact	transaction
transaminate	transamination
transcend	transcendence
transcribe	transcription
transduce	transduction
transfer	transfer
transfer	transference
transfigure	transfiguration
transform	transformation
transform	transformer
transfuse	transfusion
transgress	transgression
transistorize	transistor
transit	transit
transit	transition
translate	translation
transliterate	transliteration
translocate	translocation
transmigrate	transmigration
transmit	transmission
transmit	transmitter
transmogrify	transmogrification
transmute	transmutation
transpire	transpiration
transplant	transplant
transplant	transplantation
transport	transport
transport	transportation
transpose	transposition
transship	transshipment
transubstantiate	transubstantiation
transude	transudation
travail	travail
travel	travel
traverse	traverse
travesty	travesty
tread	tread
treat	treat
treat	treatment
treble	treble
tremble	tremble
tremor	tremor
trephine	trephination
trespass	trespass
tribulate	tribulation
trickle	trickle
trick	trick
trifurcate	trifurcation
trigger	trigger
trill	trill
trim	trim
trim	trimmer
triple	triple
trip	trip
trip	tripper
triumph	triumph
troll	troll
trot	trot
trouble	trouble
trudge	trudge
truncate	truncation
trust	trust
try	trial
try	try
tug	tug
tumble	tumble
tumefy	tumefaction
turn_around	turn_around
turn_over	turnover
turn	turn
tussle	tussle
twaddle	twaddle
twang	twang
tweak	tweak
tweet	tweet
twiddle	twiddle
twinge	twinge
twinkle	twinkle
twirl	twirl
twist	twist
twist	twister
twitch	twitch
twitter	twitter
twit	twit
type	type
typify	typification
ulcerate	ulceration
ultracentrifuge	ultracentrifugation
ululate	ululation
underachieve	underachievement
undercut	undercut
underdevelop	underdevelopment
underestimate	underestimate
underestimate	underestimation
underline	underline
undernourish	undernourishment
underpay	underpayment
underproduce	underproduction
underscore	underscore
understate	understatement
undress	undress
undulate	undulation
unify	unification
unionise	unionisation
unionize	unionization
unite	union
unitise	unitisation
unitize	unitization
update	update
upgrade	upgrade
upheave	upheaval
uplift	uplift
upset	upset
urbanise	urbanisation
urbanize	urbanization
urinate	urination
urticate	urtication
use	usance
use	use
usurp	usurpation
utilise	utilisation
utilize	utilization
vacate	vacation
vacation	vacation
vaccinate	vaccination
vacillate	vacillation
validate	validation
valuate	valuation
vaporise	vapor
vaporise	vaporisation
vaporize	vapor
vaporize	vaporization
variegate	variegation
vary	variance
vary	variation
vascularize	vascularization
vaticinate	vaticination
vault	vault
vaunt	vaunt
vegetate	vegetation
vellicate	vellication
vend	vendition
venerate	veneration
venesect	venesection
ventilate	ventilation
venture	venture
vent	vent
verbalise	verbalisation
verbalize	verbalization
versify	versification
vesicate	vesication
vesiculate	vesiculation
veto	veto
vex	vexation
vibrate	vibration
victimise	victimisation
victimize	victimization
view	view
vilify	vilification
vindicate	vindication
vinify	vinification
violate	violation
virilize	virilization
visit	visit
visit	visitation
vitalise	vitalisation
vitalize	vitalization
vitiate	vitiation
vitrify	vitrification
vituperate	vituperation
vivify	vivification
vivisect	vivisection
vocalize	vocalization
voice	voice
void	void
void	voidance
volley	volley
vomit	vomit
vote	vote
vow	vow
voyage	voyage
vulcanise	vulcanisation
vulcanize	vulcanization
vulgarise	vulgarisation
vulgarize	vulgarization
waddle	waddle
wager	wager
waggle	waggle
wag	wag
wail	wail
wait	wait
walk_over	walkover
walk	walk
wallop	wallop
wallow	wallow
waltz	waltz
wane	wane
wangle	wangle
wank	wank
want	want
warp	warp
war	war
wash	wash
waste	waste
watch	watch
waver	waver
wave	wave
wear	wear
weather	weather
weekend	weekend
welcome	welcome
weld	weld
wet	wet
whack	whack
whang	whang
wheeze	wheeze
whicker	whicker
whiff	whiff
whimper	whimper
whine	whine
whinny	whinny
whip	whip
whirlpool	whirlpool
whirl	whirl
whirr	whirr
whir	whir
whisper	whisper
whistle	whistle
whitewash	whitewash
whiz	whiz
wholesale	wholesale
whoop	whoop
wiggle	wiggle
will	will
wince	wince
wind	wind
wink	wink
winnow	winnow
winterize	winter
winter	winter
win	win
wipe	wipe
wiretap	wiretap
wire	wire
wisecrack	wisecrack
wish	wish
withdraw	withdrawal
wobble	wobble
wonder	wonder
wonder	wonderment
work	work
worry	worry
worship	worship
wound	wound
wrack	wrack
wrangle	wrangle
wreck	wreck
wrench	wrench
wrestle	wrestle
wrick	wrick
wriggle	wriggle
wring	wring
write_up	write_up
wrong	wrong
yack	yack
yarn	yarn
yawn	yawn
yaw	yaw
yell	yell
yelp	yelp
yen	yen
yield	yield
yodel	yodel
yowl	yowl
zigzag	zigzag
zoom	zoom
